L.B. Landscaping Inc,,,,,,,,,
Sales by  Customer Detail,,,,,,,,,
January - December 2022,,,,,,,,,
,,,,,,,,,
,Date,Transaction Type,Num,Product/Service,Memo/Description,Qty,Sales Price,Amount,Balance
January 2022,,,,,,,,,
,01/01/2022,Invoice,1948 - 5531,Service,,1,"9,942.12  ","9,942.12  ","9,942.12  "
,01/03/2022,Invoice,1948-5519,Service,,1,"2,096.89  ","2,096.89  ","12,039.01  "
,01/03/2022,Invoice,1948-5506,Service,,1,846.37  ,846.37  ,"12,885.38  "
,01/03/2022,Invoice,1948-5548,Service,,1,390.00  ,390.00  ,"13,275.38  "
,01/03/2022,Invoice,1948-5537,Service,,1,657.65  ,657.65  ,"13,933.03  "
,01/03/2022,Invoice,1948-5529,Service,,1,"1,915.09  ","1,915.09  ","15,848.12  "
,01/03/2022,Invoice,1948-5515,Service,,1,"1,625.40  ","1,625.40  ","17,473.52  "
,01/03/2022,Invoice,1948-5545,Service,,1,506.05  ,506.05  ,"17,979.57  "
,01/03/2022,Invoice,1948-5541,Service,,1,"2,411.67  ","2,411.67  ","20,391.24  "
,01/03/2022,Invoice,1948-5562,Service,,1,916.81  ,916.81  ,"21,308.05  "
,01/03/2022,Invoice,1948-5539,Service,,1,"6,360.00  ","6,360.00  ","27,668.05  "
,01/03/2022,Invoice,1948-5527R,Service,,1,"3,245.28  ","3,245.28  ","30,913.33  "
,01/03/2022,Invoice,1948-5509,Service,,1,441.92  ,441.92  ,"31,355.25  "
,01/03/2022,Invoice,1948-5535,Service,,1,783.05  ,783.05  ,"32,138.30  "
,01/03/2022,Invoice,1948-5549,Service,,1,720.00  ,720.00  ,"32,858.30  "
,01/03/2022,Invoice,1948-5534,Service,,1,"1,632.01  ","1,632.01  ","34,490.31  "
,01/03/2022,Invoice,1948-5514,Service,,1,583.92  ,583.92  ,"35,074.23  "
,01/03/2022,Invoice,1948-5518,Service,,1,"1,940.00  ","1,940.00  ","37,014.23  "
,01/03/2022,Invoice,1948-5558,Service,,1,"7,067.52  ","7,067.52  ","44,081.75  "
,01/03/2022,Invoice,1948-5542,Service,,1,"2,738.87  ","2,738.87  ","46,820.62  "
,01/03/2022,Invoice,1948-5557,Service,,1,"4,455.64  ","4,455.64  ","51,276.26  "
,01/03/2022,Invoice,1948-5564,Service,,1,390.00  ,390.00  ,"51,666.26  "
,01/03/2022,Invoice,1948-5550,Service,,1,"5,315.60  ","5,315.60  ","56,981.86  "
,01/03/2022,Invoice,1948-5547RR,Service,,1,"3,720.00  ","3,720.00  ","60,701.86  "
,01/03/2022,Invoice,1948-5556,Service,,1,"2,480.00  ","2,480.00  ","63,181.86  "
,01/03/2022,Invoice,1948-5523,Service,,1,"1,447.09  ","1,447.09  ","64,628.95  "
,01/03/2022,Invoice,1948-5507,Service,,1,508.48  ,508.48  ,"65,137.43  "
,01/03/2022,Invoice,1948-5521,Service,,1,"4,900.00  ","4,900.00  ","70,037.43  "
,01/03/2022,Invoice,1948-5503,Service,,1,"1,670.07  ","1,670.07  ","71,707.50  "
,01/03/2022,Invoice,1948-5533,Service,,1,"12,936.08  ","12,936.08  ","84,643.58  "
,01/03/2022,Invoice,1948-5565,Service,,1,900.00  ,900.00  ,"85,543.58  "
,01/03/2022,Invoice,1948-5551,Service,,1,"1,883.49  ","1,883.49  ","87,427.07  "
,01/03/2022,Invoice,1948-5546,Service,,1,463.28  ,463.28  ,"87,890.35  "
,01/03/2022,Invoice,1948-5552,Service,,1,494.49  ,494.49  ,"88,384.84  "
,01/03/2022,Invoice,1948-5504,Service,,1,"10,347.92  ","10,347.92  ","98,732.76  "
,01/03/2022,Invoice,1948-5536,Service,,1,"1,406.03  ","1,406.03  ","100,138.79  "
,01/03/2022,Invoice,1948-5524,Service,,1,573.18  ,573.18  ,"100,711.97  "
,01/03/2022,Invoice,1948-5543,Service,,1,422.08  ,422.08  ,"101,134.05  "
,01/03/2022,Invoice,1948-5563,Service,,1,"5,730.00  ","5,730.00  ","106,864.05  "
,01/03/2022,Invoice,1948-5544,Service,,1,"8,250.06  ","8,250.06  ","115,114.11  "
,01/03/2022,Invoice,1948-5530,Service,,1,"4,946.86  ","4,946.86  ","120,060.97  "
,01/04/2022,Invoice,1948-5560,Service,,1,190.52  ,190.52  ,"120,251.49  "
,01/04/2022,Invoice,1948-5573,Service,,1,"1,160.70  ","1,160.70  ","121,412.19  "
,01/04/2022,Invoice,1948-5571,Service,,1,"1,984.00  ","1,984.00  ","123,396.19  "
,01/04/2022,Invoice,1948-5553,Service,,1,721.39  ,721.39  ,"124,117.58  "
,01/04/2022,Invoice,1948-5570,Service,,1,550.15  ,550.15  ,"124,667.73  "
,01/04/2022,Invoice,1948-5572,Service,,1,"2,480.00  ","2,480.00  ","127,147.73  "
,01/04/2022,Invoice,1948-5568,Service,,1,"3,133.10  ","3,133.10  ","130,280.83  "
,01/04/2022,Invoice,1948-5559,Service,,1,489.52  ,489.52  ,"130,770.35  "
,01/04/2022,Invoice,1948-5569,Service,,1,551.85  ,551.85  ,"131,322.20  "
,01/05/2022,Invoice,1948-5576,Service,,1,390.00  ,390.00  ,"131,712.20  "
,01/05/2022,Invoice,1948-5574,Service,,1,157.50  ,157.50  ,"131,869.70  "
,01/05/2022,Invoice,1948-5566,Service,,1,"6,500.00  ","6,500.00  ","138,369.70  "
,01/05/2022,Invoice,1948-5561,Service,,1,"10,685.41  ","10,685.41  ","149,055.11  "
,01/05/2022,Invoice,1948-5575,Service,,1,167.20  ,167.20  ,"149,222.31  "
,01/05/2022,Invoice,1948-5578,Service,,1,"5,400.60  ","5,400.60  ","154,622.91  "
,01/05/2022,Invoice,1948-5577,Service,,1,720.00  ,720.00  ,"155,342.91  "
,01/06/2022,Invoice,1948-5513,Service,,1,"1,086.17  ","1,086.17  ","156,429.08  "
,01/06/2022,Invoice,1948-5517,Service,,1,"2,480.00  ","2,480.00  ","158,909.08  "
,01/06/2022,Invoice,1948-5538,Service,,1,"17,029.06  ","17,029.06  ","175,938.14  "
,01/07/2022,Invoice,1948-5580,Service,,1,"7,010.00  ","7,010.00  ","182,948.14  "
,01/10/2022,Invoice,1948-5579,Service,,1,"1,940.00  ","1,940.00  ","184,888.14  "
,01/12/2022,Invoice,1948-5440,Service,,1,"12,000.00  ","12,000.00  ","196,888.14  "
,01/12/2022,Invoice,1948-5585,Service,,1,477.93  ,477.93  ,"197,366.07  "
,01/12/2022,Invoice,1948-5239,Sales,,,,"8,038.80  ","205,404.87  "
,01/12/2022,Invoice,1948-5586,Service,,1,504.77  ,504.77  ,"205,909.64  "
,01/12/2022,Invoice,1948-5323,Service,,1,"1,234.40  ","1,234.40  ","207,144.04  "
,01/12/2022,Invoice,1948-5588,Service,,1,801.18  ,801.18  ,"207,945.22  "
,01/12/2022,Invoice,1948-5587,Service,,1,751.15  ,751.15  ,"208,696.37  "
,01/19/2022,Invoice,1948-5595,Service,,1,"8,700.80  ","8,700.80  ","217,397.17  "
,01/19/2022,Invoice,1948-5582,Sales,,,,"1,875.00  ","219,272.17  "
,01/19/2022,Invoice,1948-5597,Service,,1,"14,989.93  ","14,989.93  ","234,262.10  "
,01/19/2022,Invoice,1948-5596,Service,,1,"18,126.72  ","18,126.72  ","252,388.82  "
,01/19/2022,Invoice,1948-5592,Service,,1,"2,720.00  ","2,720.00  ","255,108.82  "
,01/19/2022,Invoice,1948-5590,Service,,1,"1,200.00  ","1,200.00  ","256,308.82  "
,01/19/2022,Invoice,1948-5591,Service,,1,"6,588.44  ","6,588.44  ","262,897.26  "
,01/19/2022,Invoice,1948-5593,Service,,1,"2,960.00  ","2,960.00  ","265,857.26  "
,01/19/2022,Invoice,1948-5501,Service,,1,"2,196.10  ","2,196.10  ","268,053.36  "
,01/19/2022,Invoice,1948-5589,Service,,0,,0.00  ,"268,053.36  "
,01/19/2022,Invoice,1948-5554R,Service,,1,"9,489.39  ","9,489.39  ","277,542.75  "
,01/19/2022,Invoice,1948-5594,Service,,1,"15,038.42  ","15,038.42  ","292,581.17  "
,01/21/2022,Invoice,1948-5584R,Service,,1,"2,645.00  ","2,645.00  ","295,226.17  "
,01/25/2022,Invoice,1948-5581,Service,,1,"8,015.00  ","8,015.00  ","303,241.17  "
,01/25/2022,Invoice,1948-5603,Service,,1,"6,364.05  ","6,364.05  ","309,605.22  "
,01/25/2022,Invoice,1948-5607,Service,,1,"2,344.10  ","2,344.10  ","311,949.32  "
,01/25/2022,Invoice,1948-5605,Service,,1,"18,652.20  ","18,652.20  ","330,601.52  "
,01/25/2022,Invoice,1948-5606,Service,,1,"1,037.26  ","1,037.26  ","331,638.78  "
,01/25/2022,Invoice,1948-5608,Service,,1,"29,244.20  ","29,244.20  ","360,882.98  "
,01/25/2022,Invoice,1948-5583,Service,,1,"2,515.00  ","2,515.00  ","363,397.98  "
Total for January 2022,,,,,,,,"$363,397.98  ",
February 2022,,,,,,,,,
,02/01/2022,Invoice,1948-5615,Service,,1,"2,015.20  ","2,015.20  ","2,015.20  "
,02/01/2022,Invoice,1948-5617,Service,,1,"5,160.00  ","5,160.00  ","7,175.20  "
,02/01/2022,Invoice,1948-5627,Service,,1,"1,600.00  ","1,600.00  ","8,775.20  "
,02/01/2022,Invoice,1948-5613,Service,,1,656.99  ,656.99  ,"9,432.19  "
,02/01/2022,Invoice,1948-5612,Service,,1,"4,960.00  ","4,960.00  ","14,392.19  "
,02/01/2022,Invoice,1948-5604,Service,,1,765.06  ,765.06  ,"15,157.25  "
,02/01/2022,Invoice,1948-5623,Service,,1,"2,563.64  ","2,563.64  ","17,720.89  "
,02/01/2022,Invoice,1948-5616,Service,,1,"2,441.08  ","2,441.08  ","20,161.97  "
,02/01/2022,Invoice,1948-5620,Service,,1,"10,300.00  ","10,300.00  ","30,461.97  "
,02/02/2022,Invoice,1948-5602,Sales,,,,"1,373.32  ","31,835.29  "
,02/02/2022,Invoice,1948-5602,Service,,1,0.00  ,0.00  ,"31,835.29  "
,02/02/2022,Invoice,1948-5634,Service,,1,270.00  ,270.00  ,"32,105.29  "
,02/02/2022,Invoice,1948-5625,Service,,1,765.06  ,765.06  ,"32,870.35  "
,02/10/2022,Invoice,1948-5632,Service,,1,"5,365.48  ","5,365.48  ","38,235.83  "
,02/10/2022,Invoice,1948-5642,Service,,1,"2,393.20  ","2,393.20  ","40,629.03  "
,02/10/2022,Invoice,1948-5649,Service,,1,"35,980.00  ","35,980.00  ","76,609.03  "
,02/10/2022,Invoice,1948-5614,Service,,1,"1,225.82  ","1,225.82  ","77,834.85  "
,02/10/2022,Invoice,1948-5638,Service,,1,"9,920.00  ","9,920.00  ","87,754.85  "
,02/10/2022,Invoice,1948-5630,Service,,1,207.96  ,207.96  ,"87,962.81  "
,02/10/2022,Invoice,1948-5628,Service,,1,"1,826.82  ","1,826.82  ","89,789.63  "
,02/10/2022,Invoice,1948-5621R,Service,,1,"29,800.00  ","29,800.00  ","119,589.63  "
,02/10/2022,Invoice,1948-5598,Service,,1,"27,596.71  ","27,596.71  ","147,186.34  "
,02/10/2022,Invoice,1948-5633,Service,,1,665.20  ,665.20  ,"147,851.54  "
,02/10/2022,Invoice,1948-5626,Service,,1,702.81  ,702.81  ,"148,554.35  "
,02/10/2022,Invoice,1948-5619,Service,,1,535.56  ,535.56  ,"149,089.91  "
,02/10/2022,Invoice,1948-5639,Service,,1,"24,481.92  ","24,481.92  ","173,571.83  "
,02/10/2022,Invoice,1948-5640,Service,,1,"3,795.00  ","3,795.00  ","177,366.83  "
,02/10/2022,Invoice,1948-5618,Service,,1,209.49  ,209.49  ,"177,576.32  "
,02/10/2022,Invoice,1948-5650,Service,,1,"8,410.00  ","8,410.00  ","185,986.32  "
,02/10/2022,Invoice,1948-5629,Service,,1,"2,224.40  ","2,224.40  ","188,210.72  "
,02/10/2022,Invoice,1948-5624,Service,,1,"3,830.36  ","3,830.36  ","192,041.08  "
,02/10/2022,Invoice,1948-5636,Service,,1,"1,409.16  ","1,409.16  ","193,450.24  "
,02/10/2022,Invoice,1948-5631,Service,,1,"1,149.16  ","1,149.16  ","194,599.40  "
,02/10/2022,Invoice,1948-5555,Service,,1,"55,830.06  ","55,830.06  ","250,429.46  "
,02/17/2022,Invoice,1948-5600,Service,,1,"24,043.44  ","24,043.44  ","274,472.90  "
,02/17/2022,Invoice,1948-5641,Service,,1,"4,260.36  ","4,260.36  ","278,733.26  "
,02/17/2022,Invoice,1948-5645,Service,,1,"1,305.46  ","1,305.46  ","280,038.72  "
,02/17/2022,Invoice,1948-5599,Service,,1,"18,884.81  ","18,884.81  ","298,923.53  "
,02/17/2022,Invoice,1948-5652R,Service,,1,"2,628.00  ","2,628.00  ","301,551.53  "
,02/17/2022,Invoice,1948-5651,Service,,1,"2,260.00  ","2,260.00  ","303,811.53  "
,02/23/2022,Invoice,1948-5644,Service,,1,663.63  ,663.63  ,"304,475.16  "
,02/23/2022,Invoice,1948-5666,Service,,1,"2,260.00  ","2,260.00  ","306,735.16  "
,02/23/2022,Invoice,1948-5635,Service,,1,633.03  ,633.03  ,"307,368.19  "
,02/23/2022,Invoice,1948-5659R,Service,,1,"2,980.50  ","2,980.50  ","310,348.69  "
,02/23/2022,Invoice,1948-5667,Sales,,,,"7,534.75  ","317,883.44  "
,02/23/2022,Invoice,1948-5665,Service,,1,"2,221.46  ","2,221.46  ","320,104.90  "
,02/23/2022,Invoice,1948-5647,Service,,1,707.62  ,707.62  ,"320,812.52  "
,02/23/2022,Invoice,1948-5648,Service,,1,947.10  ,947.10  ,"321,759.62  "
,02/23/2022,Invoice,1948-5658,Service,,1,"2,436.71  ","2,436.71  ","324,196.33  "
,02/23/2022,Invoice,1948-5657,Service,,1,"6,778.00  ","6,778.00  ","330,974.33  "
,02/23/2022,Invoice,1948-5646,Service,,1,723.40  ,723.40  ,"331,697.73  "
,02/23/2022,Invoice,1948-5637,Service,,1,"24,267.01  ","24,267.01  ","355,964.74  "
,02/23/2022,Invoice,1948-5656R,Service,,1,"1,800.00  ","1,800.00  ","357,764.74  "
,02/25/2022,Invoice,1948 - 5673,Service,,1,"11,490.00  ","11,490.00  ","369,254.74  "
,02/25/2022,Invoice,1948 - 5664,Service,,1,"4,272.23  ","4,272.23  ","373,526.97  "
,02/25/2022,Invoice,1948 - 5655,Service,,1,"3,830.24  ","3,830.24  ","377,357.21  "
,02/25/2022,Invoice,1948 - 5678,Service,,1,"7,878.00  ","7,878.00  ","385,235.21  "
,02/25/2022,Invoice,1948 - 5671,Service,,1,"1,776.46  ","1,776.46  ","387,011.67  "
,02/25/2022,Invoice,1948 - 5653,Service,,1,"21,191.05  ","21,191.05  ","408,202.72  "
,02/25/2022,Invoice,1948 - 5668,Service,,1,"10,631.44  ","10,631.44  ","418,834.16  "
,02/25/2022,Invoice,1948 - 5677,Service,,1,"27,755.66  ","27,755.66  ","446,589.82  "
,02/25/2022,Invoice,1948 - 5662,Service,,1,"3,873.50  ","3,873.50  ","450,463.32  "
,02/25/2022,Invoice,1948 - 5672,Service,,1,"59,143.70  ","59,143.70  ","509,607.02  "
,02/25/2022,Invoice,1948 - 5676,Service,,1,"2,840.24  ","2,840.24  ","512,447.26  "
Total for February 2022,,,,,,,,"$512,447.26  ",
March 2022,,,,,,,,,
,03/05/2022,Invoice,1948 - 5601,Service,,1,"23,368.98  ","23,368.98  ","23,368.98  "
,03/05/2022,Invoice,1948 - 5522R,Service,,1,"6,000.00  ","6,000.00  ","29,368.98  "
,03/05/2022,Invoice,1948 - 5684,Service,,1,"43,080.22  ","43,080.22  ","72,449.20  "
,03/05/2022,Invoice,1948 - 5661,Service,,1,"2,264.88  ","2,264.88  ","74,714.08  "
,03/05/2022,Invoice,1948 - 5587,Service,,0,,0.00  ,"74,714.08  "
,03/05/2022,Invoice,1948 - 5567,Service,,1,"2,480.00  ","2,480.00  ","77,194.08  "
,03/05/2022,Invoice,1948 - 5643,Sales,,,,"1,264.65  ","78,458.73  "
,03/05/2022,Invoice,1948 - 5670,Service,,1,"3,751.12  ","3,751.12  ","82,209.85  "
,03/05/2022,Invoice,1948 - 5654,Service,,1,673.04  ,673.04  ,"82,882.89  "
,03/05/2022,Invoice,1948 - 5669,Service,,1,"7,960.00  ","7,960.00  ","90,842.89  "
,03/05/2022,Invoice,1948 - 5609,Service,,1,"14,019.19  ","14,019.19  ","104,862.08  "
,03/09/2022,Invoice,1948 - 5682,Service,,1,"2,096.26  ","2,096.26  ","106,958.34  "
,03/09/2022,Invoice,1948 - 5696,Service,,1,"7,100.10  ","7,100.10  ","114,058.44  "
,03/09/2022,Invoice,1948 - 5663R,Service,,1,"5,256.00  ","5,256.00  ","119,314.44  "
,03/09/2022,Invoice,1948 - 5681,Service,,1,"1,343.24  ","1,343.24  ","120,657.68  "
,03/09/2022,Invoice,1948 - 5694,Service,,1,134.56  ,134.56  ,"120,792.24  "
,03/09/2022,Invoice,1948 - 5683,Service,,1,"3,184.65  ","3,184.65  ","123,976.89  "
,03/09/2022,Invoice,1948 - 5680,Service,,1,652.81  ,652.81  ,"124,629.70  "
,03/09/2022,Invoice,1948 - 5679,Service,,1,621.99  ,621.99  ,"125,251.69  "
,03/09/2022,Invoice,1948 - 5692,Service,,1,"2,480.00  ","2,480.00  ","127,731.69  "
,03/09/2022,Invoice,1948 - 5691,Service,,1,785.00  ,785.00  ,"128,516.69  "
,03/09/2022,Invoice,1948 - 5689,Service,,1,"1,940.00  ","1,940.00  ","130,456.69  "
,03/10/2022,Invoice,1948-5711,Service,,1,"2,499.11  ","2,499.11  ","132,955.80  "
,03/15/2022,Invoice,1948 - 5698,Service,,1,"47,636.14  ","47,636.14  ","180,591.94  "
,03/15/2022,Invoice,1948 - 5687,Service,,1,855.00  ,855.00  ,"181,446.94  "
,03/15/2022,Invoice,1948 - 5716,Service,,1,235.36  ,235.36  ,"181,682.30  "
,03/15/2022,Invoice,1948 - 5699,Service,,1,"1,264.66  ","1,264.66  ","182,946.96  "
,03/15/2022,Invoice,1948 - 5688,Service,,1,"31,380.98  ","31,380.98  ","214,327.94  "
,03/15/2022,Invoice,1948 - 5685,Service,,1,708.17  ,708.17  ,"215,036.11  "
,03/15/2022,Invoice,1948 - 5702,Service,,1,"1,940.00  ","1,940.00  ","216,976.11  "
,03/15/2022,Invoice,1948 - 5674,Service,,1,"17,586.81  ","17,586.81  ","234,562.92  "
,03/15/2022,Invoice,1948 - 5708,Service,,1,904.04  ,904.04  ,"235,466.96  "
,03/15/2022,Invoice,1948 - 5704,Service,,1,767.78  ,767.78  ,"236,234.74  "
,03/15/2022,Invoice,1948 - 5706,Service,,1,162.25  ,162.25  ,"236,396.99  "
,03/15/2022,Invoice,1948 - 5701,Service,,1,"1,823.00  ","1,823.00  ","238,219.99  "
,03/15/2022,Invoice,1948 - 5705,Service,,1,748.57  ,748.57  ,"238,968.56  "
,03/15/2022,Invoice,1948 - 5660,Service,,1,"4,645.00  ","4,645.00  ","243,613.56  "
,03/15/2022,Invoice,1948 - 5700,Service,,1,"1,093.04  ","1,093.04  ","244,706.60  "
,03/21/2022,Invoice,1948 - 5718,Service,,1,"4,450.44  ","4,450.44  ","249,157.04  "
,03/21/2022,Invoice,1948 - 5717,Service,,1,"2,070.20  ","2,070.20  ","251,227.24  "
,03/21/2022,Invoice,1948 - 5690,Service,,1,"6,171.00  ","6,171.00  ","257,398.24  "
,03/21/2022,Invoice,1948 - 5695,Service,,1,"5,561.22  ","5,561.22  ","262,959.46  "
,03/21/2022,Invoice,1948 - 5707,Service,,1,851.74  ,851.74  ,"263,811.20  "
,03/21/2022,Invoice,1948 - 5709,Sales,,,,837.80  ,"264,649.00  "
,03/21/2022,Invoice,1948 - 5693,Service,,1,"2,480.00  ","2,480.00  ","267,129.00  "
,03/21/2022,Invoice,1948 - 5725,Service,,1,"1,940.00  ","1,940.00  ","269,069.00  "
,03/21/2022,Invoice,1948 - 5721,Service,,1,"11,305.54  ","11,305.54  ","280,374.54  "
,03/21/2022,Invoice,1948 - 5722,Service,,1,"1,940.00  ","1,940.00  ","282,314.54  "
,03/21/2022,Invoice,1948 - 5697,Service,,1,"6,840.13  ","6,840.13  ","289,154.67  "
,03/22/2022,Invoice,1948 - 5727,Service,,1,"58,941.30  ","58,941.30  ","348,095.97  "
,03/25/2022,Invoice,1948 - 5611R,Service,,1,"4,380.00  ","4,380.00  ","352,475.97  "
,03/25/2022,Invoice,1948 - 5710,Sales,,,,"1,889.98  ","354,365.95  "
,03/25/2022,Invoice,1948 - 5703,Service,,1,"1,947.16  ","1,947.16  ","356,313.11  "
,03/25/2022,Invoice,1948 - 5714,Sales,,,,703.57  ,"357,016.68  "
,03/25/2022,Invoice,1948 - 5715,Service,,1,"1,767.37  ","1,767.37  ","358,784.05  "
,03/25/2022,Invoice,1948-5730,Service,,1,867.82  ,867.82  ,"359,651.87  "
,03/25/2022,Invoice,1948 - 5713,Service,,1,"1,632.12  ","1,632.12  ","361,283.99  "
,03/25/2022,Invoice,1948 - 5736,Service,,1,"2,730.24  ","2,730.24  ","364,014.23  "
,03/25/2022,Invoice,1948 - 5726,Sales,,,,"1,412.48  ","365,426.71  "
,03/25/2022,Invoice,1948 - 5675R,Service,,1,"4,956.17  ","4,956.17  ","370,382.88  "
,03/25/2022,Invoice,1948 - 5743,Service,,1,"1,940.00  ","1,940.00  ","372,322.88  "
,03/25/2022,Invoice,1948 - 5720,Service,,1,629.23  ,629.23  ,"372,952.11  "
Total for March 2022,,,,,,,,"$372,952.11  ",
April 2022,,,,,,,,,
,04/15/2022,Invoice,1948-5729,Service,,1,813.73  ,813.73  ,813.73  
,04/19/2022,Invoice,1948 - 5774,Service,,1,"7,023.74  ","7,023.74  ","7,837.47  "
,04/19/2022,Invoice,1948 - 5733R,Service,,1,"3,249.98  ","3,249.98  ","11,087.45  "
,04/19/2022,Invoice,1948 - 5730R,Service,,1,688.44  ,688.44  ,"11,775.89  "
,04/19/2022,Invoice,1948 - 5768,Service,,1,"2,480.00  ","2,480.00  ","14,255.89  "
,04/19/2022,Invoice,1948 - 5758,Service,,1,"16,998.81  ","16,998.81  ","31,254.70  "
,04/19/2022,Invoice,1948 - 5748,Service,,1,"6,550.60  ","6,550.60  ","37,805.30  "
,04/19/2022,Invoice,1948 - 5738R,Service,,1,"6,213.50  ","6,213.50  ","44,018.80  "
,04/19/2022,Invoice,1948 - 5729R,Service,,1,659.98  ,659.98  ,"44,678.78  "
,04/19/2022,Invoice,1948 - 5728R,Service,,1,"1,159.96  ","1,159.96  ","45,838.74  "
,04/19/2022,Invoice,1948 - 5737R,Service,,1,"1,454.66  ","1,454.66  ","47,293.40  "
,04/19/2022,Invoice,1948 - 5757,Service,,1,"1,310.12  ","1,310.12  ","48,603.52  "
,04/19/2022,Invoice,1948 - 5759,Service,,1,"1,625.16  ","1,625.16  ","50,228.68  "
,04/19/2022,Invoice,1948 - 5741,Service,,1,"5,308.96  ","5,308.96  ","55,537.64  "
,04/19/2022,Invoice,1948 - 5749,Service,,1,"11,411.65  ","11,411.65  ","66,949.29  "
,04/19/2022,Invoice,1948 - 5739R,Service,,1,"1,586.61  ","1,586.61  ","68,535.90  "
,04/19/2022,Invoice,1948 - 5762,Service,,1,"6,970.00  ","6,970.00  ","75,505.90  "
,04/19/2022,Invoice,1948 - 5723R,Service,,1,"2,860.00  ","2,860.00  ","78,365.90  "
,04/19/2022,Invoice,1948 - 5720R,Service,,1,475.48  ,475.48  ,"78,841.38  "
,04/19/2022,Invoice,1948 - 5740,Sales,,,,934.82  ,"79,776.20  "
,04/19/2022,Invoice,1948 - 5740,Service,,1,0.00  ,0.00  ,"79,776.20  "
,04/19/2022,Invoice,1948 - 5731R,Service,,1,604.74  ,604.74  ,"80,380.94  "
,04/19/2022,Invoice,1948 - 5732R,Service,,1,604.74  ,604.74  ,"80,985.68  "
,04/19/2022,Invoice,1948 - 5750,Service,,1,534.74  ,534.74  ,"81,520.42  "
,04/19/2022,Invoice,1948 - 5734R,Service,,1,160.75  ,160.75  ,"81,681.17  "
,04/19/2022,Invoice,1948 - 5735R,Service,,1,821.64  ,821.64  ,"82,502.81  "
,04/19/2022,Invoice,1948 - 5747,Service,,1,"18,770.46  ","18,770.46  ","101,273.27  "
,04/19/2022,Invoice,1948 - 5742,Service,,1,"2,558.82  ","2,558.82  ","103,832.09  "
,04/19/2022,Invoice,1948 - 5726R,Service,,1,"1,104.98  ","1,104.98  ","104,937.07  "
,04/19/2022,Invoice,1948 - 5770,Service,,1,"3,430.16  ","3,430.16  ","108,367.23  "
,04/19/2022,Invoice,1948 - 5751,Service,,1,"6,378.70  ","6,378.70  ","114,745.93  "
,04/19/2022,Invoice,1948 - 5769,Service,,1,"3,850.28  ","3,850.28  ","118,596.21  "
,04/19/2022,Invoice,1948 - 5712R,Service,,1,"5,829.10  ","5,829.10  ","124,425.31  "
,04/19/2022,Invoice,1948 - 5775,Service,,1,997.30  ,997.30  ,"125,422.61  "
,04/19/2022,Invoice,1948 - 5756,Service,,1,"2,810.00  ","2,810.00  ","128,232.61  "
,04/19/2022,Invoice,1948 - 5767,Service,,1,"4,195.00  ","4,195.00  ","132,427.61  "
,04/19/2022,Invoice,1948 - 5765,Service,,1,"3,710.00  ","3,710.00  ","136,137.61  "
,04/19/2022,Invoice,1948 - 5746,Service,,1,"16,000.00  ","16,000.00  ","152,137.61  "
,04/19/2022,Invoice,1948 - 5753,Service,,1,"1,940.00  ","1,940.00  ","154,077.61  "
,04/19/2022,Invoice,1948 - 5745,Service,,1,"2,680.00  ","2,680.00  ","156,757.61  "
,04/19/2022,Invoice,1948 - 5763,Service,,1,"6,481.00  ","6,481.00  ","163,238.61  "
,04/20/2022,Invoice,1948 - 5719,Service,,1,"3,157.29  ","3,157.29  ","166,395.90  "
,04/28/2022,Invoice,1948 - 5754,Service,,1,797.24  ,797.24  ,"167,193.14  "
,04/28/2022,Invoice,1948 - 5760,Service,,1,614.74  ,614.74  ,"167,807.88  "
,04/28/2022,Invoice,1948 - 5791,Service,,1,0.00  ,0.00  ,"167,807.88  "
,04/28/2022,Invoice,1948 - 5791,Sales,,,,"2,480.00  ","170,287.88  "
,04/28/2022,Invoice,1948 - 5782,Service,,1,"1,249.04  ","1,249.04  ","171,536.92  "
,04/28/2022,Invoice,1948 - 5772R,Service,,1,"2,277.00  ","2,277.00  ","173,813.92  "
,04/28/2022,Invoice,1948 - 5777,Service,,1,"17,525.00  ","17,525.00  ","191,338.92  "
,04/28/2022,Invoice,1948 - 5786,Sales,,,,"1,738.84  ","193,077.76  "
,04/28/2022,Invoice,1948 - 5796,Service,,1,"2,480.00  ","2,480.00  ","195,557.76  "
,04/28/2022,Invoice,1948 - 5778,Service,,1,"2,605.79  ","2,605.79  ","198,163.55  "
,04/28/2022,Invoice,1948 - 5755,Service,,1,"12,746.48  ","12,746.48  ","210,910.03  "
,04/28/2022,Invoice,1948 - 5766,Service,,1,"2,784.64  ","2,784.64  ","213,694.67  "
,04/28/2022,Invoice,1948 - 5785,Service,,1,"2,296.64  ","2,296.64  ","215,991.31  "
,04/28/2022,Invoice,1948 - 5776R,Service,,1,"3,280.00  ","3,280.00  ","219,271.31  "
,04/28/2022,Invoice,1948 - 5784,Service,,1,804.66  ,804.66  ,"220,075.97  "
,04/28/2022,Invoice,1948 - 5783,Service,,1,"1,462.62  ","1,462.62  ","221,538.59  "
,04/28/2022,Invoice,1948 - 5779,Service,,1,"4,960.00  ","4,960.00  ","226,498.59  "
,04/28/2022,Invoice,1948 - 5801,Service,,1,"2,573.32  ","2,573.32  ","229,071.91  "
,04/28/2022,Invoice,1948 - 5764,Service,,1,"15,502.83  ","15,502.83  ","244,574.74  "
,04/28/2022,Invoice,1948 - 5787,Sales,,,,666.76  ,"245,241.50  "
,04/28/2022,Invoice,1948 - 5771,Service,,1,982.04  ,982.04  ,"246,223.54  "
,04/28/2022,Invoice,1948 - 5773,Service,,1,"1,044.90  ","1,044.90  ","247,268.44  "
,04/28/2022,Invoice,1948 - 5802,Service,,1,"1,905.00  ","1,905.00  ","249,173.44  "
,04/28/2022,Invoice,1948 - 5761,Service,,1,658.38  ,658.38  ,"249,831.82  "
,04/28/2022,Invoice,1948 - 5790,Service,,1,"23,410.00  ","23,410.00  ","273,241.82  "
,04/28/2022,Invoice,1948 - 5780,Service,,1,"1,310.12  ","1,310.12  ","274,551.94  "
,04/29/2022,Invoice,1948 - 5792,Service,,1,"1,662.62  ","1,662.62  ","276,214.56  "
,04/29/2022,Invoice,1948 - 5799,Service,,1,759.87  ,759.87  ,"276,974.43  "
,04/29/2022,Invoice,1948 - 5788,Service,,1,"4,195.00  ","4,195.00  ","281,169.43  "
,04/29/2022,Invoice,1948 - 5800,Service,,1,"1,940.00  ","1,940.00  ","283,109.43  "
,04/29/2022,Invoice,1948 - 5686,Service,,1,"67,808.90  ","67,808.90  ","350,918.33  "
,04/29/2022,Invoice,1948 - 5794,Service,,1,"1,355.74  ","1,355.74  ","352,274.07  "
Total for April 2022,,,,,,,,"$352,274.07  ",
May 2022,,,,,,,,,
,05/03/2022,Invoice,1948 - 5798,Service,,1,"16,850.00  ","16,850.00  ","16,850.00  "
,05/03/2022,Invoice,1948 - 5797,Service,,1,"9,981.00  ","9,981.00  ","26,831.00  "
,05/03/2022,Invoice,1948 - 5795,Service,,1,564.38  ,564.38  ,"27,395.38  "
,05/03/2022,Invoice,1948 - 5793,Service,,1,"4,875.34  ","4,875.34  ","32,270.72  "
,05/06/2022,Invoice,1948 - 5808,Service,,1,"2,480.00  ","2,480.00  ","34,750.72  "
,05/06/2022,Invoice,1948 - 5803,Service,,1,"5,540.00  ","5,540.00  ","40,290.72  "
,05/06/2022,Invoice,1948 - 5819,Service,,1,"2,568.32  ","2,568.32  ","42,859.04  "
,05/17/2022,Invoice,1948 - 5789,Service,,1,"2,480.00  ","2,480.00  ","45,339.04  "
,05/18/2022,Invoice,1948 - 5744,Service,,1,911.78  ,911.78  ,"46,250.82  "
,05/18/2022,Invoice,1948 - 5811,Service,,1,"2,749.88  ","2,749.88  ","49,000.70  "
,05/18/2022,Invoice,1948 - 5809,Service,,1,"7,440.00  ","7,440.00  ","56,440.70  "
,05/18/2022,Invoice,1948 - 5805,Service,,1,713.50  ,713.50  ,"57,154.20  "
,05/18/2022,Invoice,1948 - 5814,Service,,1,"6,753.75  ","6,753.75  ","63,907.95  "
,05/18/2022,Invoice,1948 - 5810,Service,,1,"2,314.58  ","2,314.58  ","66,222.53  "
,05/18/2022,Invoice,1948 - 5817,Service,,1,"3,630.00  ","3,630.00  ","69,852.53  "
,05/18/2022,Invoice,1948 - 5825,Service,,1,"1,755.00  ","1,755.00  ","71,607.53  "
,05/18/2022,Invoice,1948 - 5816,Service,,1,742.40  ,742.40  ,"72,349.93  "
,05/18/2022,Invoice,1948 - 5812,Service,,1,"2,785.24  ","2,785.24  ","75,135.17  "
,05/18/2022,Invoice,1948 - 5815,Service,,1,"3,060.71  ","3,060.71  ","78,195.88  "
,05/18/2022,Invoice,1948 - 5826,Service,,1,"4,450.00  ","4,450.00  ","82,645.88  "
,05/18/2022,Invoice,1948 - 5818,Service,,1,"1,940.00  ","1,940.00  ","84,585.88  "
,05/18/2022,Invoice,1948 - 5807,Service,,1,628.50  ,628.50  ,"85,214.38  "
,05/18/2022,Invoice,1948 - 5822,Service,,1,"4,865.42  ","4,865.42  ","90,079.80  "
,05/18/2022,Invoice,1948 - 5824,Service,,1,"1,422.16  ","1,422.16  ","91,501.96  "
,05/18/2022,Invoice,1948 - 5804,Service,,1,"8,000.00  ","8,000.00  ","99,501.96  "
,05/18/2022,Invoice,1948 - 5806,Service,,1,829.86  ,829.86  ,"100,331.82  "
,05/18/2022,Invoice,1948 - 5820,Service,,1,"222,863.49  ","222,863.49  ","323,195.31  "
,05/18/2022,Invoice,1948 - 5813,Service,,1,"9,090.40  ","9,090.40  ","332,285.71  "
,05/20/2022,Invoice,1948 - 5823,Service,,1,"10,830.56  ","10,830.56  ","343,116.27  "
,05/20/2022,Invoice,1948 - 5838,Service,,1,"1,940.00  ","1,940.00  ","345,056.27  "
,05/27/2022,Invoice,1948 - 5828,Service,,1,"1,592.52  ","1,592.52  ","346,648.79  "
,05/27/2022,Invoice,1948 - 5833,Service,,1,180.20  ,180.20  ,"346,828.99  "
,05/27/2022,Invoice,1948 - 5835,Service,,1,"1,973.60  ","1,973.60  ","348,802.59  "
,05/27/2022,Invoice,1948 - 5847,Service,,1,965.24  ,965.24  ,"349,767.83  "
,05/27/2022,Invoice,1948 - 5849,Service,,1,"1,255.19  ","1,255.19  ","351,023.02  "
,05/27/2022,Invoice,1948 - 5846,Service,,1,"4,985.44  ","4,985.44  ","356,008.46  "
,05/27/2022,Invoice,1948 - 5844,Service,,1,"8,650.00  ","8,650.00  ","364,658.46  "
,05/27/2022,Invoice,1948 - 5842,Service,,1,"3,780.00  ","3,780.00  ","368,438.46  "
,05/27/2022,Invoice,1948 - 5832,Service,,1,"7,512.00  ","7,512.00  ","375,950.46  "
,05/27/2022,Invoice,1948 - 5848,Service,,1,785.14  ,785.14  ,"376,735.60  "
,05/27/2022,Invoice,1948 - 5850,Service,,1,"2,335.67  ","2,335.67  ","379,071.27  "
,05/27/2022,Invoice,1948 - 5829,Service,,1,"3,821.28  ","3,821.28  ","382,892.55  "
,05/27/2022,Invoice,1948 - 5827,Service,,1,"1,944.57  ","1,944.57  ","384,837.12  "
,05/27/2022,Invoice,1948 - 5845,Service,,1,"1,429.99  ","1,429.99  ","386,267.11  "
,05/27/2022,Invoice,1948 - 5834,Service,,1,764.88  ,764.88  ,"387,031.99  "
,05/27/2022,Invoice,1948 - 5839,Service,,1,667.97  ,667.97  ,"387,699.96  "
,05/27/2022,Invoice,1948 - 5830,Service,,1,"6,500.00  ","6,500.00  ","394,199.96  "
,05/27/2022,Invoice,1948 - 5841,Service,,1,"3,200.00  ","3,200.00  ","397,399.96  "
,05/27/2022,Invoice,1948 - 5837,Service,,1,"10,700.23  ","10,700.23  ","408,100.19  "
,05/27/2022,Invoice,1948 - 5843,Service,,1,"7,720.00  ","7,720.00  ","415,820.19  "
Total for May 2022,,,,,,,,"$415,820.19  ",
June 2022,,,,,,,,,
,06/02/2022,Invoice,1948 - 5852,Service,,1,"1,940.00  ","1,940.00  ","1,940.00  "
,06/13/2022,Invoice,1948 - 5856,Service,,1,"1,940.00  ","1,940.00  ","3,880.00  "
,06/13/2022,Invoice,1948 - 5857,Service,,1,"28,148.00  ","28,148.00  ","32,028.00  "
,06/13/2022,Invoice,1948 - 5840R,Service,,1,"7,500.00  ","7,500.00  ","39,528.00  "
,06/13/2022,Invoice,1948 - 5855,Service,,1,"1,815.00  ","1,815.00  ","41,343.00  "
,06/13/2022,Invoice,1948 - 5853,Service,,1,"5,627.80  ","5,627.80  ","46,970.80  "
,06/13/2022,Invoice,1948 - 5854,Service,,1,"1,185.48  ","1,185.48  ","48,156.28  "
,06/13/2022,Invoice,1948 - 5851,Service,,1,289.14  ,289.14  ,"48,445.42  "
,06/16/2022,Invoice,1948-5863,Service,,1,"1,940.00  ","1,940.00  ","50,385.42  "
,06/16/2022,Invoice,1948-5864,Service,,1,"4,960.00  ","4,960.00  ","55,345.42  "
,06/16/2022,Invoice,1948-5858,Service,,1,"1,254.16  ","1,254.16  ","56,599.58  "
,06/16/2022,Invoice,1948-5872,Service,,1,"7,601.81  ","7,601.81  ","64,201.39  "
,06/16/2022,Invoice,1948-5860,Service,,1,325.49  ,325.49  ,"64,526.88  "
,06/16/2022,Invoice,1948-5831,Service,,1,"68,416.29  ","68,416.29  ","132,943.17  "
,06/16/2022,Invoice,1948-5859,Service,,1,"1,476.96  ","1,476.96  ","134,420.13  "
,06/16/2022,Invoice,1948-5867,Service,,1,"1,324.17  ","1,324.17  ","135,744.30  "
,06/29/2022,Invoice,1948-5882,Sales,,,,"2,480.00  ","138,224.30  "
,06/29/2022,Invoice,1948-5869,Service,,1,"2,480.00  ","2,480.00  ","140,704.30  "
,06/29/2022,Invoice,1948-5866,Service,,1,"6,500.00  ","6,500.00  ","147,204.30  "
,06/29/2022,Invoice,1948-5836,Service,,1,"1,277.11  ","1,277.11  ","148,481.41  "
,06/29/2022,Invoice,1948-5893,Service,,1,"6,500.00  ","6,500.00  ","154,981.41  "
,06/29/2022,Invoice,1948-5888,Service,,1,667.08  ,667.08  ,"155,648.49  "
,06/29/2022,Invoice,1948-5879,Service,,1,633.58  ,633.58  ,"156,282.07  "
,06/29/2022,Invoice,1948-5875,Sales,,,,"2,423.88  ","158,705.95  "
,06/29/2022,Invoice,1948-5874,Service,,1,"2,423.07  ","2,423.07  ","161,129.02  "
,06/29/2022,Invoice,1948-5876,Service,,1,176.38  ,176.38  ,"161,305.40  "
,06/29/2022,Invoice,1948-5880,Service,,1,"4,345.65  ","4,345.65  ","165,651.05  "
,06/29/2022,Invoice,1948-5870,Service,,1,"1,080.00  ","1,080.00  ","166,731.05  "
,06/29/2022,Invoice,1948-5883,Sales,,,,"9,600.00  ","176,331.05  "
,06/29/2022,Invoice,1948-5871,Service,,1,"3,220.00  ","3,220.00  ","179,551.05  "
,06/29/2022,Invoice,1948-5881,Service,,1,760.00  ,760.00  ,"180,311.05  "
,06/29/2022,Invoice,1948-5878,Service,,1,"2,640.00  ","2,640.00  ","182,951.05  "
,06/29/2022,Invoice,1948-5877,Service,,1,742.00  ,742.00  ,"183,693.05  "
,06/29/2022,Invoice,1948-5861,Service,,1,"2,649.24  ","2,649.24  ","186,342.29  "
,06/29/2022,Invoice,1948-5886,Service,,1,"2,666.96  ","2,666.96  ","189,009.25  "
,06/29/2022,Invoice,1948-5873,Sales,,,,"1,860.00  ","190,869.25  "
Total for June 2022,,,,,,,,"$190,869.25  ",
July 2022,,,,,,,,,
,07/07/2022,Invoice,1948-5892,Service,,1,"4,980.00  ","4,980.00  ","4,980.00  "
,07/07/2022,Invoice,1948-5896,Service,,1,961.16  ,961.16  ,"5,941.16  "
,07/07/2022,Invoice,1948 - 5910,Service,,1,724.93  ,724.93  ,"6,666.09  "
,07/07/2022,Invoice,1948-5897,Service,,1,"1,925.20  ","1,925.20  ","8,591.29  "
,07/07/2022,Invoice,1948-5890,Service,,1,"1,230.02  ","1,230.02  ","9,821.31  "
,07/07/2022,Invoice,1948-5862,Service,,1,"1,830.00  ","1,830.00  ","11,651.31  "
,07/07/2022,Invoice,1948-5891,Service,,1,"12,985.00  ","12,985.00  ","24,636.31  "
,07/07/2022,Invoice,1948-5889,Service,,1,549.00  ,549.00  ,"25,185.31  "
,07/07/2022,Invoice,1948-5895,Service,,1,"2,696.80  ","2,696.80  ","27,882.11  "
,07/07/2022,Invoice,1948-5887,Service,,1,"1,110.00  ","1,110.00  ","28,992.11  "
,07/07/2022,Invoice,1948-5894,Service,,1,152.17  ,152.17  ,"29,144.28  "
,07/12/2022,Invoice,1948-5905R,Service,,1,"2,830.00  ","2,830.00  ","31,974.28  "
,07/12/2022,Invoice,1948-5904,Service,,1,"2,480.00  ","2,480.00  ","34,454.28  "
,07/12/2022,Invoice,1948-5906,Service,,1,"5,125.00  ","5,125.00  ","39,579.28  "
,07/12/2022,Invoice,1948-5885,Service,,1,0.00  ,0.00  ,"39,579.28  "
,07/12/2022,Invoice,1948-5912,Service,,1,"2,086.09  ","2,086.09  ","41,665.37  "
,07/12/2022,Invoice,1948-5898,Service,,1,"3,400.00  ","3,400.00  ","45,065.37  "
,07/12/2022,Invoice,1948-5903,Service,,1,"1,980.00  ","1,980.00  ","47,045.37  "
,07/12/2022,Invoice,1948-5912,Service,,1,"3,000.00  ","3,000.00  ","50,045.37  "
,07/12/2022,Invoice,1948-5885,Sales,,,,"3,880.00  ","53,925.37  "
,07/13/2022,Invoice,1948-5907,Service,,1,89.88  ,89.88  ,"54,015.25  "
,07/13/2022,Invoice,1948-5902,Service,,1,"9,130.16  ","9,130.16  ","63,145.41  "
,07/13/2022,Invoice,1948-5901,Service,,1,685.62  ,685.62  ,"63,831.03  "
,07/13/2022,Invoice,1948-5911,Service,,1,"2,172.66  ","2,172.66  ","66,003.69  "
,07/13/2022,Invoice,1948-5899,Service,,1,"5,061.50  ","5,061.50  ","71,065.19  "
,07/13/2022,Invoice,1948-5900,Service,,1,998.34  ,998.34  ,"72,063.53  "
,07/13/2022,Invoice,1948-5908,Service,,1,78.00  ,78.00  ,"72,141.53  "
,07/14/2022,Invoice,1948-5914,Sales,,,,"2,950.00  ","75,091.53  "
,07/14/2022,Invoice,1948-5909,Service,,1,"1,209.55  ","1,209.55  ","76,301.08  "
,07/14/2022,Invoice,1948-5917,Service,,1,"1,932.19  ","1,932.19  ","78,233.27  "
,07/14/2022,Invoice,1948-5919,Service,,1,"8,000.55  ","8,000.55  ","86,233.82  "
,07/15/2022,Invoice,1948-5921,Service,,1,"3,011.38  ","3,011.38  ","89,245.20  "
,07/18/2022,Invoice,1948-5924,Service,,1,"1,925.98  ","1,925.98  ","91,171.18  "
,07/25/2022,Invoice,1948-5920,Sales,,,,"2,190.08  ","93,361.26  "
,07/25/2022,Invoice,1948-5927R,Service,,1,"4,517.32  ","4,517.32  ","97,878.58  "
,07/25/2022,Invoice,1948-5915,Service,,1,"2,726.00  ","2,726.00  ","100,604.58  "
,07/25/2022,Invoice,1948-5926,Service,,1,"1,700.00  ","1,700.00  ","102,304.58  "
,07/25/2022,Invoice,1948-5884,Service,,1,"1,644.98  ","1,644.98  ","103,949.56  "
,07/25/2022,Invoice,1948-5925,Service,,1,"4,530.00  ","4,530.00  ","108,479.56  "
,07/27/2022,Invoice,1948-5930,Service,,1,"11,037.51  ","11,037.51  ","119,517.07  "
,07/27/2022,Invoice,1948-5929,Service,,1,"1,240.00  ","1,240.00  ","120,757.07  "
,07/27/2022,Invoice,1948-5918,Service,,1,"2,277.19  ","2,277.19  ","123,034.26  "
,07/28/2022,Invoice,1948-5922,Service,,1,"5,826.00  ","5,826.00  ","128,860.26  "
,07/28/2022,Invoice,1948-5916,Service,,1,"5,360.00  ","5,360.00  ","134,220.26  "
,07/28/2022,Invoice,1948-5928,Service,,1,600.00  ,600.00  ,"134,820.26  "
Total for July 2022,,,,,,,,"$134,820.26  ",
August 2022,,,,,,,,,
,08/04/2022,Invoice,1948 - 5940R,Service,,1,"6,034.52  ","6,034.52  ","6,034.52  "
,08/05/2022,Invoice,1948-5913,Service,,1,"7,665.68  ","7,665.68  ","13,700.20  "
,08/05/2022,Invoice,1948-5939,Sales,,,,"4,428.00  ","18,128.20  "
,08/05/2022,Invoice,1948-5942R,Service,,1,"22,722.30  ","22,722.30  ","40,850.50  "
,08/05/2022,Invoice,1948 - 5938,Service,,1,"4,550.00  ","4,550.00  ","45,400.50  "
,08/05/2022,Invoice,1948-5943R,Service,,1,"2,524.70  ","2,524.70  ","47,925.20  "
,08/05/2022,Invoice,1948-5944,Sales,,,,397.94  ,"48,323.14  "
,08/08/2022,Invoice,1948-5932,Service,,1,497.19  ,497.19  ,"48,820.33  "
,08/08/2022,Invoice,1948-5935,Service,,1,613.35  ,613.35  ,"49,433.68  "
,08/08/2022,Invoice,1948-5946,Service,,1,"1,620.80  ","1,620.80  ","51,054.48  "
,08/08/2022,Invoice,1948-5933,Service,,1,920.68  ,920.68  ,"51,975.16  "
,08/08/2022,Invoice,1948-5955,Service,,1,"2,440.00  ","2,440.00  ","54,415.16  "
,08/11/2022,Invoice,1948-5957,Service,,1,"12,585.00  ","12,585.00  ","67,000.16  "
,08/11/2022,Invoice,1948-5950,Sales,,,,"1,296.82  ","68,296.98  "
,08/11/2022,Invoice,1948-5934,Sales,,,,"1,351.70  ","69,648.68  "
,08/11/2022,Invoice,1948-5959,Service,,1,"1,940.00  ","1,940.00  ","71,588.68  "
,08/11/2022,Invoice,1948-5961,Service,,1,"2,647.15  ","2,647.15  ","74,235.83  "
,08/11/2022,Invoice,1948-5945,Service,,1,"1,899.89  ","1,899.89  ","76,135.72  "
,08/11/2022,Invoice,1948-5958,Service,,1,"2,383.96  ","2,383.96  ","78,519.68  "
,08/11/2022,Invoice,1948-5962,Service,,1,"3,495.00  ","3,495.00  ","82,014.68  "
,08/11/2022,Invoice,1948-5963,Service,,1,"9,870.00  ","9,870.00  ","91,884.68  "
,08/11/2022,Invoice,1948-5964,Sales,,,,"2,480.00  ","94,364.68  "
,08/11/2022,Invoice,1948-5936,Service,,1,"33,948.00  ","33,948.00  ","128,312.68  "
,08/11/2022,Invoice,1948-5931,Service,,1,720.61  ,720.61  ,"129,033.29  "
,08/11/2022,Invoice,1948-5965,Service,,1,"4,960.00  ","4,960.00  ","133,993.29  "
,08/11/2022,Invoice,1948-5947,Service,,1,797.13  ,797.13  ,"134,790.42  "
,08/11/2022,Invoice,1948-5956,Service,,1,"2,129.00  ","2,129.00  ","136,919.42  "
,08/16/2022,Invoice,1948-5952,Service,,1,87.00  ,87.00  ,"137,006.42  "
,08/16/2022,Invoice,1948-5821,Service,,1,"24,762.61  ","24,762.61  ","161,769.03  "
,08/16/2022,Invoice,1948-5948,Service,,1,"1,589.79  ","1,589.79  ","163,358.82  "
,08/16/2022,Invoice,1948-5953,Service,,1,"1,886.50  ","1,886.50  ","165,245.32  "
,08/16/2022,Invoice,1948-5967R,Service,,1,"5,678.00  ","5,678.00  ","170,923.32  "
,08/16/2022,Invoice,1948-5966,Service,,1,"5,360.00  ","5,360.00  ","176,283.32  "
,08/16/2022,Invoice,1948-5970,Service,,1,277.14  ,277.14  ,"176,560.46  "
,08/16/2022,Invoice,1948-5949,Service,,1,"1,089.85  ","1,089.85  ","177,650.31  "
,08/16/2022,Invoice,1948-5951,Service,,1,674.50  ,674.50  ,"178,324.81  "
,08/16/2022,Invoice,1948-5954,Service,,1,797.23  ,797.23  ,"179,122.04  "
,08/17/2022,Invoice,1948-5978,Service,,1,"1,240.52  ","1,240.52  ","180,362.56  "
,08/17/2022,Invoice,1948-5971,Service,,1,"2,485.48  ","2,485.48  ","182,848.04  "
,08/17/2022,Invoice,1948-5868,Service,,1,"54,240.55  ","54,240.55  ","237,088.59  "
,08/17/2022,Invoice,1948-5968,Service,,1,"1,680.08  ","1,680.08  ","238,768.67  "
,08/17/2022,Invoice,1948-5973,Service,,1,"11,164.64  ","11,164.64  ","249,933.31  "
,08/17/2022,Invoice,1948-5974,Service,,1,"2,830.00  ","2,830.00  ","252,763.31  "
,08/17/2022,Invoice,1948-5937,Service,,1,"62,545.13  ","62,545.13  ","315,308.44  "
,08/19/2022,Invoice,1948-5975,Sales,,,,"1,240.00  ","316,548.44  "
,08/19/2022,Invoice,1948-5975,Service,,1,0.00  ,0.00  ,"316,548.44  "
,08/19/2022,Invoice,1948-5969,Service,,1,"3,796.64  ","3,796.64  ","320,345.08  "
,08/19/2022,Invoice,1948-5972,Service,,1,0.00  ,,"320,345.08  "
,08/19/2022,Invoice,1948-5972,Service,,1,575.44  ,575.44  ,"320,920.52  "
,08/19/2022,Invoice,1948-5980,Service,,1,"1,240.00  ","1,240.00  ","322,160.52  "
,08/20/2022,Invoice,1948-5923,Service,,1,"1,323.58  ","1,323.58  ","323,484.10  "
,08/26/2022,Invoice,1948-5991,Service,,1,"3,840.00  ","3,840.00  ","327,324.10  "
Total for August 2022,,,,,,,,"$327,324.10  ",
September 2022,,,,,,,,,
,09/01/2022,Invoice,1948-5997,Service,,1,"2,480.00  ","2,480.00  ","2,480.00  "
,09/01/2022,Invoice,1948-5979,Sales,,1,0.00  ,0.00  ,"2,480.00  "
,09/01/2022,Invoice,1948-5979,Sales,,,,"3,500.00  ","5,980.00  "
,09/07/2022,Invoice,1948-6005,Service,,1,"3,460.00  ","3,460.00  ","9,440.00  "
,09/08/2022,Invoice,1948-5982,Service,,1,"1,849.12  ","1,849.12  ","11,289.12  "
,09/08/2022,Invoice,1948-5994,Service,,1,330.24  ,330.24  ,"11,619.36  "
,09/08/2022,Invoice,1948-5981,Service,,1,"2,084.41  ","2,084.41  ","13,703.77  "
,09/08/2022,Invoice,1948-5990,Service,,1,"1,349.95  ","1,349.95  ","15,053.72  "
,09/08/2022,Invoice,1948-5984,Service,,1,"1,815.13  ","1,815.13  ","16,868.85  "
,09/08/2022,Invoice,1948-5983,Service,,1,"3,780.00  ","3,780.00  ","20,648.85  "
,09/08/2022,Invoice,1948-5988,Service,,1,"4,956.00  ","4,956.00  ","25,604.85  "
,09/08/2022,Invoice,1948-5993,Service,,1,"1,485.10  ","1,485.10  ","27,089.95  "
,09/08/2022,Invoice,1948-5977,Service,,1,"4,327.40  ","4,327.40  ","31,417.35  "
,09/08/2022,Invoice,1948-5987,Service,,1,"2,141.70  ","2,141.70  ","33,559.05  "
,09/08/2022,Invoice,1948-5989,Service,,1,"58,796.00  ","58,796.00  ","92,355.05  "
,09/08/2022,Invoice,1948-6001,Service,,1,"12,531.18  ","12,531.18  ","104,886.23  "
,09/08/2022,Invoice,1948-5976,Service,,1,"2,187.15  ","2,187.15  ","107,073.38  "
,09/13/2022,Invoice,1948-6006,Service,,1,"1,668.10  ","1,668.10  ","108,741.48  "
,09/13/2022,Invoice,1948-6010,Service,,1,"1,270.00  ","1,270.00  ","110,011.48  "
,09/13/2022,Invoice,1948-6000,Service,,1,"1,570.00  ","1,570.00  ","111,581.48  "
,09/13/2022,Invoice,1948-6007,Service,,1,"3,764.95  ","3,764.95  ","115,346.43  "
,09/13/2022,Invoice,1948-6004,Service,,1,940.50  ,940.50  ,"116,286.93  "
,09/13/2022,Invoice,1948-6011,Service,,1,217.63  ,217.63  ,"116,504.56  "
,09/13/2022,Invoice,1948-6002,Service,,1,"1,394.50  ","1,394.50  ","117,899.06  "
,09/13/2022,Invoice,1948-5992,Service,,1,"3,500.00  ","3,500.00  ","121,399.06  "
,09/21/2022,Invoice,1948-5985,Service,,1,"2,612.20  ","2,612.20  ","124,011.26  "
,09/28/2022,Invoice,1948-6012,Service,,1,"1,782.49  ","1,782.49  ","125,793.75  "
,09/28/2022,Invoice,1948-6009,Service,,1,"1,751.41  ","1,751.41  ","127,545.16  "
,09/28/2022,Invoice,1948-6025,Service,,1,"2,142.11  ","2,142.11  ","129,687.27  "
,09/28/2022,Invoice,1948-6021,Service,,1,910.24  ,910.24  ,"130,597.51  "
,09/28/2022,Invoice,1948-6017,Service,,1,288.86  ,288.86  ,"130,886.37  "
,09/28/2022,Invoice,1948-6014,Service,,1,"1,459.00  ","1,459.00  ","132,345.37  "
,09/28/2022,Invoice,1948-6013,Service,,1,"2,650.00  ","2,650.00  ","134,995.37  "
,09/28/2022,Invoice,1948-6024,Service,,1,900.43  ,900.43  ,"135,895.80  "
,09/28/2022,Invoice,1948-6018,Service,,1,728.50  ,728.50  ,"136,624.30  "
,09/28/2022,Invoice,1948-6026,Service,,1,"4,367.40  ","4,367.40  ","140,991.70  "
,09/28/2022,Invoice,1948-6028,Service,,1,"1,955.00  ","1,955.00  ","142,946.70  "
,09/28/2022,Invoice,1948-6023R,Service,,1,"1,160.00  ","1,160.00  ","144,106.70  "
,09/28/2022,Invoice,1948-6027R,Service,,1,"9,220.00  ","9,220.00  ","153,326.70  "
,09/28/2022,Invoice,1948-6030,Service,,1,"27,412.20  ","27,412.20  ","180,738.90  "
,09/28/2022,Invoice,1948-6016,Service,,1,"2,480.00  ","2,480.00  ","183,218.90  "
,09/28/2022,Invoice,1948-6008,Service,,1,"1,089.85  ","1,089.85  ","184,308.75  "
,09/28/2022,Invoice,1948-6015,Service,,1,"2,172.49  ","2,172.49  ","186,481.24  "
,09/28/2022,Invoice,1948-5986,Service,,1,"1,530.72  ","1,530.72  ","188,011.96  "
,09/28/2022,Invoice,1948-6019,Service,,1,"1,581.64  ","1,581.64  ","189,593.60  "
,09/28/2022,Invoice,1948-6020,Service,,1,956.68  ,956.68  ,"190,550.28  "
,09/28/2022,Invoice,1948-5999,Service,,1,"1,653.76  ","1,653.76  ","192,204.04  "
,09/28/2022,Invoice,1948-6031,Service,,1,"3,045.80  ","3,045.80  ","195,249.84  "
,09/30/2022,Invoice,1948-6032,Service,,1,790.39  ,790.39  ,"196,040.23  "
,09/30/2022,Invoice,1948-5998,Service,,1,"6,939.60  ","6,939.60  ","202,979.83  "
,09/30/2022,Invoice,1948-6033,Service,,1,"4,415.66  ","4,415.66  ","207,395.49  "
,09/30/2022,Invoice,1948-6022,Sales,,,,"4,270.00  ","211,665.49  "
,09/30/2022,Invoice,1948-5995,Service,,1,"1,649.00  ","1,649.00  ","213,314.49  "
,09/30/2022,Invoice,1948-6029,Sales,,,,"9,700.00  ","223,014.49  "
,09/30/2022,Invoice,1948-5960,Service,,1,"1,340.50  ","1,340.50  ","224,354.99  "
Total for September 2022,,,,,,,,"$224,354.99  ",
October 2022,,,,,,,,,
,10/07/2022,Invoice,1948-6036,Service,,1,"15,000.00  ","15,000.00  ","15,000.00  "
,10/07/2022,Invoice,1948-6034,Service,,1,"1,855.30  ","1,855.30  ","16,855.30  "
,10/07/2022,Invoice,1948-6035,Service,,1,"3,720.00  ","3,720.00  ","20,575.30  "
,10/19/2022,Invoice,1948 - 6053,Service,,1,"2,053.30  ","2,053.30  ","22,628.60  "
,10/19/2022,Invoice,1948 - 6048,Sales,,,,"1,824.00  ","24,452.60  "
,10/19/2022,Invoice,1948 - 6058,Sales,,,,"5,287.00  ","29,739.60  "
,10/19/2022,Invoice,1948-5996,Sales,,,,"1,630.16  ","31,369.76  "
,10/19/2022,Invoice,1948 - 6049,Sales,,,,"6,754.00  ","38,123.76  "
,10/20/2022,Invoice,1948 - 6051,Service,,1,888.99  ,888.99  ,"39,012.75  "
,10/20/2022,Invoice,1948 - 6056,Service,,1,620.50  ,620.50  ,"39,633.25  "
,10/20/2022,Invoice,1948 - 6042,Service,,1,716.50  ,716.50  ,"40,349.75  "
,10/20/2022,Invoice,1948 - 6046,Service,,1,"4,536.00  ","4,536.00  ","44,885.75  "
,10/20/2022,Invoice,1948 - 5998R,Service,,1,"5,731.60  ","5,731.60  ","50,617.35  "
,10/20/2022,Invoice,1948 - 6043,Service,,1,"2,600.00  ","2,600.00  ","53,217.35  "
,10/20/2022,Invoice,1948 - 6050,Service,,1,888.67  ,888.67  ,"54,106.02  "
,10/20/2022,Invoice,1948 - 6041,Service,,1,127.29  ,127.29  ,"54,233.31  "
,10/20/2022,Invoice,1948 - 6044,Service,,1,"1,418.50  ","1,418.50  ","55,651.81  "
,10/20/2022,Invoice,1948 - 6045,Service,,1,923.80  ,923.80  ,"56,575.61  "
,10/26/2022,Invoice,1948 - 6061,Service,,1,674.50  ,674.50  ,"57,250.11  "
,10/26/2022,Invoice,1948 - 5941,Service,,1,"18,296.00  ","18,296.00  ","75,546.11  "
,10/26/2022,Invoice,1948 - 6038,Service,,1,0.00  ,0.00  ,"75,546.11  "
,10/26/2022,Invoice,1948 - 6052,Service,,1,"6,500.00  ","6,500.00  ","82,046.11  "
,10/26/2022,Invoice,1948 - 6069,Service,,1,"2,083.00  ","2,083.00  ","84,129.11  "
,10/26/2022,Invoice,1948 - 6062,Service,,1,125.87  ,125.87  ,"84,254.98  "
,10/26/2022,Invoice,1948 - 6057,Service,,1,620.50  ,620.50  ,"84,875.48  "
,10/26/2022,Invoice,1948 - 6066,Service,,1,310.00  ,310.00  ,"85,185.48  "
,10/26/2022,Invoice,1948 - 6040,Sales,,1,"13,767.93  ","13,767.93  ","98,953.41  "
,10/26/2022,Invoice,1948 - 6047,Service,,1,"2,830.12  ","2,830.12  ","101,783.53  "
,10/26/2022,Invoice,1948 - 6059,Service,,1,"4,253.10  ","4,253.10  ","106,036.63  "
,10/26/2022,Invoice,1948 - 6063,Service,,1,959.95  ,959.95  ,"106,996.58  "
,10/26/2022,Invoice,1948 - 6054,Service,,1,310.00  ,310.00  ,"107,306.58  "
,10/26/2022,Invoice,1948 - 6037,Service,,1,"29,692.00  ","29,692.00  ","136,998.58  "
,10/26/2022,Invoice,1948 - 6068,Service,,1,"14,590.00  ","14,590.00  ","151,588.58  "
,10/26/2022,Invoice,1948 - 6038,Sales,,,,"1,431.70  ","153,020.28  "
Total for October 2022,,,,,,,,"$153,020.28  ",
November 2022,,,,,,,,,
,11/04/2022,Invoice,1948 - 6072,Service,,1,200.00  ,200.00  ,200.00  
,11/04/2022,Invoice,1948 - 6070,Service,,1,"4,960.00  ","4,960.00  ","5,160.00  "
,11/04/2022,Invoice,1948 - 6067,Service,,1,"1,960.00  ","1,960.00  ","7,120.00  "
,11/04/2022,Invoice,1948 - 6076,Service,,1,"2,680.00  ","2,680.00  ","9,800.00  "
,11/04/2022,Invoice,1948 - 6073,Service,,1,"1,840.00  ","1,840.00  ","11,640.00  "
,11/04/2022,Invoice,1948 - 6065,Service,,1,857.00  ,857.00  ,"12,497.00  "
,11/04/2022,Invoice,1948 - 6071,Service,,1,777.10  ,777.10  ,"13,274.10  "
,11/04/2022,Invoice,1948 - 6064,Service,,1,"1,429.21  ","1,429.21  ","14,703.31  "
,11/04/2022,Invoice,1948 - 6020,Service,,1,956.68  ,956.68  ,"15,659.99  "
,11/04/2022,Invoice,1948 - 6055,Service,,1,"6,009.78  ","6,009.78  ","21,669.77  "
,11/04/2022,Invoice,1948 - 6075,Service,,1,"9,555.00  ","9,555.00  ","31,224.77  "
,11/04/2022,Invoice,1948 - 6018a,Service,,1,60.10  ,60.10  ,"31,284.87  "
,11/04/2022,Invoice,1948 - 6074,Service,,1,"1,340.00  ","1,340.00  ","32,624.87  "
,11/04/2022,Invoice,1948 - 6077,Service,,1,"23,638.50  ","23,638.50  ","56,263.37  "
,11/16/2022,Invoice,1948 - 6039,Sales,,,,733.36  ,"56,996.73  "
,11/16/2022,Invoice,1948 - 6039,Service,,1,0.00  ,0.00  ,"56,996.73  "
,11/16/2022,Invoice,1948 - 6084,Service,,1,"9,040.00  ","9,040.00  ","66,036.73  "
,11/16/2022,Invoice,1948 - 6082,Service,,1,"1,653.67  ","1,653.67  ","67,690.40  "
,11/16/2022,Invoice,1948 - 6079,Service,,1,"5,650.53  ","5,650.53  ","73,340.93  "
,11/16/2022,Invoice,1948 - 6060,Service,,1,"21,570.00  ","21,570.00  ","94,910.93  "
,11/16/2022,Invoice,1948 - 6087,Service,,1,"1,200.42  ","1,200.42  ","96,111.35  "
,11/16/2022,Invoice,1948 - 6098,Sales,,,,"3,095.00  ","99,206.35  "
,11/16/2022,Invoice,1948 - 6094,Service,,1,204.00  ,204.00  ,"99,410.35  "
,11/16/2022,Invoice,1948 - 6091,Service,,1,"3,123.90  ","3,123.90  ","102,534.25  "
,11/16/2022,Invoice,1948 - 6080,Service,,1,"1,510.00  ","1,510.00  ","104,044.25  "
,11/16/2022,Invoice,1948 - 6097,Service,,1,"20,300.00  ","20,300.00  ","124,344.25  "
,11/16/2022,Invoice,1948 - 6095,Service,,1,919.95  ,919.95  ,"125,264.20  "
,11/16/2022,Invoice,1948 - 6093,Service,,1,"1,908.95  ","1,908.95  ","127,173.15  "
,11/16/2022,Invoice,1948 - 6088,Service,,1,"1,069.60  ","1,069.60  ","128,242.75  "
,11/16/2022,Invoice,1948 - 6090,Service,,1,"2,802.10  ","2,802.10  ","131,044.85  "
,11/16/2022,Invoice,1948 - 6086,Service,,1,"1,184.54  ","1,184.54  ","132,229.39  "
,11/16/2022,Invoice,1948 - 6089,Service,,1,"4,811.69  ","4,811.69  ","137,041.08  "
,11/16/2022,Invoice,1948 - 6085,Service,,1,"2,031.70  ","2,031.70  ","139,072.78  "
,11/16/2022,Invoice,1948 - 6083,Service,,1,"1,180.00  ","1,180.00  ","140,252.78  "
,11/16/2022,Invoice,1948 - 6081,Service,,1,"1,787.62  ","1,787.62  ","142,040.40  "
,11/16/2022,Invoice,1948 - 6092,Service,,1,"4,704.00  ","4,704.00  ","146,744.40  "
Total for November 2022,,,,,,,,"$146,744.40  ",
December 2022,,,,,,,,,
,12/02/2022,Invoice,1948 - 6099,Sales,,,,"9,518.67  ","9,518.67  "
,12/02/2022,Invoice,1948 - 6111,Service,,1,"1,745.67  ","1,745.67  ","11,264.34  "
,12/02/2022,Invoice,1948 - 6109,Service,,1,"4,960.00  ","4,960.00  ","16,224.34  "
,12/02/2022,Invoice,1948 - 6112,Service,,1,"5,040.00  ","5,040.00  ","21,264.34  "
,12/02/2022,Invoice,1948 - 6106,Service,,1,683.74  ,683.74  ,"21,948.08  "
,12/02/2022,Invoice,1948 - 6103,Sales,,,,225.00  ,"22,173.08  "
,12/02/2022,Invoice,1948 - 6105,Service,,1,633.73  ,633.73  ,"22,806.81  "
,12/02/2022,Invoice,1948 - 6096,Service,,1,789.90  ,789.90  ,"23,596.71  "
,12/02/2022,Invoice,1948 - 6102,Service,,1,"5,542.16  ","5,542.16  ","29,138.87  "
,12/02/2022,Invoice,1948 - 6104,Service,,1,620.00  ,620.00  ,"29,758.87  "
,12/02/2022,Invoice,1948 - 6101,Service,,1,837.18  ,837.18  ,"30,596.05  "
,12/02/2022,Invoice,1948 - 6023RR,Service,,1,95.70  ,95.70  ,"30,691.75  "
,12/02/2022,Invoice,1948 - 6100,Service,,1,"9,062.50  ","9,062.50  ","39,754.25  "
,12/02/2022,Invoice,1948 - 6108,Service,,1,"2,600.00  ","2,600.00  ","42,354.25  "
,12/02/2022,Invoice,1948 - 6078,Service,,1,"2,626.50  ","2,626.50  ","44,980.75  "
,12/02/2022,Invoice,1948 - 6114,Service,,1,"2,560.00  ","2,560.00  ","47,540.75  "
,12/02/2022,Invoice,1948 - 6110,Service,,1,"1,398.00  ","1,398.00  ","48,938.75  "
,12/02/2022,Invoice,1948 - 6107,Service,,1,"4,170.00  ","4,170.00  ","53,108.75  "
Total for December 2022,,,,,,,,"$53,108.75  ",
TOTAL,,,,,,,,"$3,247,133.64  ",
,,,,,,,,,
,,,,,,,,,
"Monday, Dec 12, 2022 08:47:15 PM GMT-8 - Accrual Basis",,,,,,,,,
